char	correct_char
a	a
á	á
à	à
â	â
ă	ă
ã	ã
å	a
ấ	ấ
ầ	ầ
ắ	ắ
ằ	ằ
ẫ	ẫ
ẵ	ẵ
ả	ả
ẩ	ẩ
ẳ	ẳ
ạ	ạ
ậ	ậ
ặ	ặ
b	b
c	c
d	d
đ	đ
e	e
é	é
è	è
ê	ê
ẽ	ẽ
ế	ế
ề	ề
ễ	ễ
ẻ	ẻ
ể	ể
ẹ	ẹ
ệ	ệ
f	f
g	g
h	h
i	i
í	í
ì	ì
ĩ	ĩ
ỉ	ỉ
ị	ị
j	j
k	k
l	l
m	m
n	n
o	o
ó	ó
ò	ò
ô	ô
ö	o
õ	õ
ố	ố
ồ	ồ
ỗ	ỗ
ỏ	ỏ
ơ	ơ
ổ	ổ
ọ	ọ
ớ	ớ
ờ	ờ
ỡ	ỡ
ộ	ộ
ở	ở
ợ	ợ
p	p
q	q
r	r
s	s
t	t
u	u
ú	ú
ù	ù
ū	u
ũ	ũ
ủ	ủ
ư	ư
ụ	ụ
ứ	ứ
ừ	ừ
ữ	ữ
ử	ử
ự	ự
v	v
w	w
x	x
y	y
ý	ý
ỳ	ỳ
ỹ	ỹ
ỷ	ỷ
ỵ	ỵ
z	z
