dau buoi	đầu buồi
daubuoi	đầu buồi
caidaubuoi	cái đầu buồi
nhucaidaubuoi	như cái đầu buồi
dau boi	đầu buồi
dauboi	đầu bòi
caidauboi	cái đầu bòi
đầu bòy	đầu bòi
đầu bùi	đầu buồi
dau boy	đầu bòi
dauboy	đầu bòi
caidauboy	cái đầu bòi
concak	con cặc
nungcak	nứng cặc
bucak	bú cặc
caiconcac	cái con cặc
caiconcak	cái con cặc
cuccut	cục cức
cười ẻ	cười ỉa
dell ngửi	đéo ngửi
dell ngui	đéo ngửi
dell chịu	đéo chịu
dell chiu	đéo chịu
dell hiểu	đéo hiểu
dell hieu	đéo hiểu
dellhieukieugi	đéo hiểu kiểu gì
dell nói	đéo nói
dell noi	đéo nói
dellnoinhieu	đéo nói nhiều
dell biết	đéo biết
dell biet	đéo biết
dell nghe	đéo nghe
dell ăn	đéo ăn
dell an	đéo ăn
dell được	đéo được
dell duoc	đéo được
dell làm	đéo làm
dell lam	đéo làm
dell đi	đéo đi
dell di	đéo đi
dell chạy	đéo chạy
dell chay	đéo chạy
deohieukieugi	đéo hiểu kiểu gì
đm	địt mẹ
dm	địt mẹ
đmm	địt mẹ mày
dmm	địt mẹ mày
đmmm	địt mẹ mày
đcm	địt con mẹ
dcm	địt con mẹ
đcmm	địt con mẹ mày
dis me	địt mẹ
disme	địt mẹ
dismje	địt mẹ
dismia	địt mẹ
dis mia	địt mẹ
dis mie	địt mẹ
đis mịa	địt mẹ
đis mịe	địt mẹ
ditmemayconcho	địt mẹ mày con chó
ditmemay	địt mẹ mày
ditmethangoccho	địt mẹ mày thằng chó
ditmeconcho	địt mẹ con chó
dmconcho	địt mẹ con chó
ditmecondi	địt mẹ con đĩ
ditmecondicho	địt mẹ con đĩ chó
doma	đụ má
duoma	đụ má
cđĩ	con đĩ
đilol	đĩ lồn
điloz	đĩ lồn
đilon	đĩ lồn
diloz	đĩ lồn
dilol	đĩ lồn
dilon	đĩ lồn
condi	con đĩ
dime	đĩ mẹ
di me	đĩ mẹ
dimemay	đĩ mẹ mày
condime	con đĩ mẹ
condimemay	con đĩ mẹ
condicho	con đĩ chó
matlon	mặt lồn
cailon	cái lồn
matlol	mặt lồn
matloz	mặt lồn
thml	thằng mặt lồn
thangmatlon	thằng mặt lồn
thangml	thằng mặt lồn
tml	thằng mặt lồn
thml	thằng mặt lồn
diml	đĩ mặt lồn
dml	đĩ mặt lồn
xàm lol	xàm lồn
xam lol	xàm lồn
xạo lol	xạo lồn
xao lol	xạo lồn
con lol	con lol
ăn lol	ăn lồn
an lol	ăn lồn
ham lol	hãm lồn
củ lol	củ lồn
cu lol	củ lồn
ngu lol	ngu lồn
tuổi lol	tuổi lồn
tuoi lol	tuổi lồn
mõm lol	mõm lồn
nứng lol	nứng lồn
nung lol	nứng lồn
nug lol	nứng lồn
nuglol	nứng lồn
rảnh lol	rảnh lồn
ranh lol	rảnh lồn
banh lol	banh lồn
tét lol	tét lồn
vạch lol	vạch lồn
vach lol	vạch lồn
cào lol	cào lồn
cao lol	cào lồn
tung lol	tung lồn
mặt lol	mặt lồn
xàm lon	xàm lồn
xam lon	xàm lồn
xạo lon	xạo lồn
xao lon	xạo lồn
ham lon	hãm lồn
clgt	cái lồn gì thế
sml	sấp mặt lồn
sapmatlol	sấp mặt lồn
sapmatlon	sấp mặt lồn
sapmatloz	sấp mặt lồn
vlon	vãi lồn
vloz	vãi lồn
vlol	vãi lồn
vailon	vãi lồn
vailol	vãi lồn
vcl	vãi cả lồn
vl	vãi lồn
vleu	vãi lồn
xephinh	xếp hình
chich choac	chịch choạc
buscu	bú cu
occho	óc chó
cmn	con mẹ nó
clmn	cái lồn mẹ nó
